o1,1,1,0
o2,1,0,1
o3,1,0,2
o4,1,0,3
o5,0,0,2
o6,0,0,1
o7,0,0,0
o8,0,0,3
o9,0,0,1
o10,0,0,0
o1,1,0,1
o2,1,1,0
o3,1,0,1
o4,1,1,2
o5,0,0,0
o6,0,0,2
o7,0,0,0
o8,0,0,3
o9,0,0,1
o10,0,0,2